NO ./textures/wall_1.xpm
SO ./textures/wall_1.xpm
WE ./textures/wall_1.xpm
EA ./textures/wall_1.xpm

C 28,28,28
F 28,28,28

10001
10001
10E01
10001
11111
