NO textures/wall_1.xpm
SO textures/wall_2.xpm
WE textures/wall_3.xpm
EA textures/wall_4.xpm

F 150,75,0
C 41,117,119

11111111
10000001
10001001
100000N1
11111111
